ashe juniper=juniper, ashe;ashei juniperus
juniper species=juniper spp.
pecan=southern pecan
texas mountain laurel=bean, mescal (texas mountain laurel)
mountain laurel=mt. laurel
carolina cherry laurel=carolina laurel cherry;laurelcherry, carolina
willow=false willow;desert willow;willow, desert;black willow;willow, black;willow spp.;willow species;willow, weeping
vacant site=vacant vite;vacant site, small;vacant site, large;vacant - replant;vacant planting site - small;vacant planting site - medium;vacant planting site - large
brush=brush pile
mexican plum=plum, mexican
redbud=eastern redbud;mexican redbud;redbud species;texas redbud;redbud, texas;redbud, eastern;redbud, mexican;redbud, oklahoma
mesquite=mesquite species;mesquite, honey;mesquite, chilean;honey mesquite;thornless chilean mesquite
privet=glossy privet;chinese privet;privet species;privet, japanese;privet, glossy;japanese privet;ligustrum;waxleaf ligustrum
chinaberry=chinaberrytree
crape myrtle=crape myrtle (including hybrids);crapemyrtle
goldenball leadtree=golden leadball
persimmon=texas persimmon;common persimmon;japanese persimmon;persimmon, texas;persimmon, common;persimmon, japanese;american persimmon
pistache=chinese pistache;pistache, chinese;pistache, texas
yaupon holly=yaupon;yaupon, holly
mulberry=mulberry spp.;paper mulberry;red mulberry;white mulberry;mulberry, red;mulberry, white;mulberry, paper;mulberry. texas;mulberry, texas
gum bumelia=bumelia;bully, gum
sycamore=sycamore spp.;american sycamore;mexican sycamore;sycamore, mexican;sycamore, american;sycamore. mexican
catalpa=eastern catalpa;catalpa, northern;catalpa, southern;western catalpa
soapberry=western soapberry;soapberry, western;soapberry, wingleaf
pine=yew pine;pine, loblolly;pine, japanese black;pine, afghan;pine, italian stone;pine, austrain;pine, jeffery;italian stone pine;afghan pine
silk tree=mimosa, silk tree;silktree
arborvitae=oriental arborvitae
chinese tallow=chinese tallow tree;tallow, chinese
palo verde=paloverde, texas
box elder=boxelder
maple=red maple;bigtooth maple;maple, bigtooth;maple, silver;maple, sugar;maple, red;shantung maple;trident maple
cottonwood=cottonwood, eastern;eastern cottonwood
locust=honey locust;locust, black;honeylocust;black locust
loquat=bronze loquat;edible loquat;loquat, common;loquat, bronze
osage orange=bois dâ€™arc
palm=palm spp.;mexican fan palm;palm species;palm, california fan;palmetto, rio grande;mexican sabal palm;california fan palm;palmetto;windmill palm;pindo palm;canary island date palm;mediterranean fan palm;guadalupe palm
sweetgum=american sweet gum;american sweetgum;sweet gum
buckeye=mexican buckeye;buckeye, mexican;buckeye, ohio
walnut=black walnut;walnut species;walnut, black;walnut, little
tree of heaven=ailanthus
eve's necklace=necklacepod, eves
photinia=fraser photinia;photinia, frasier;photinia, taiwanese;chinese photinia
acacia=acacia species;sweet acacia;acacia, sweet;acacia, shoestring;shoestring acacia;small's acacia
anacacho orchid=anacacho orchid tree
carolina buckthorn=buckthorn, carolina
flamegold=chinese flame tree;formosa flamegold
chinese parasol tree=parasol, chinese
cypress=baldcypress;arizona cypress;bald cypress;italian cypress;monterey cypress;montezuma cypress;cypress, bald;cypress, italian;cypress, montezuma bald;cypress, arizona;cypress, leyland;cypress, monterey;cypress, bald.r
dogwood=dogwood species;dogwood, roughleaf
pear=bradford pear;edible pear;pear, callery;callery pear;ornamental pear
oak=live oak;bur oak;chinkapin oak;mexican white oak;monterrey oak;shumard oak;post oak;canby oak;blackjack oak;chinquapin oak;lacey oak;monterey oak;red oak;sawtooth oak;southern live oak;southern red oak;white oak;oak, bur;oak, texas red;oak, mexican white (netleaf);oak, post;oak, live (southern);oak, texas live (escarpment);oak, chinquapin;oak, nuttall;oak, shumard;oak, lacey;oak, blackjack;oak, sawtooth;oak, willow;oak, northern red;oak, water;oak, bastard;oak, emory;oak, chisos red;oak, overcup;oak, scarlet oak;oak, white;oak, mexican white;oak, burr;oak, live;chisos , red oak;oak, chisos;oak, white shin;oak, american live;oak, mexican;texas red oak;oak, monterey white;chisos red oak;oak, red;chisoâ€™s red oak;shin oak;burr oak;mexican whie oak;love oak;escarpment live oak;durand oak;buckley oak;cork oak
ash=arizona ash;texas ash;ash spp.;green ash;ash, texas;ash, velvet (arizona ash);ash, green;ash, northern mountain;ash, white;pricklyash, common;mexican ash
elm=cedar elm;lacebark elm;american elm;chinese elm;elm species;siberian elm;elm, cedar;elm, american;elm, chinese (lacebark elm);elm, siberian;elm, slippery;elm, frontier;elm, texas;elm, winged
cedar=eastern red cedar;cedar, eastern red;cedar, deodar;deodar cedar
common hackberry=hackberry, common